##########
.......#..
.......#.x
####...#..
..........
...T...###
..........
##....T...
x.......@.
#####.....