########################################
.........#.........#.........#.........#
.........#.........#.........#.........#
####.....#.........#.........#.........#
.........#.........#.........#.........#
...T....##.........#.........#.........#
x..................#.........#.........#
##...T.............#.........#.........#
##.................#.........#.........#
#####..............#.........#.........#
........................................
x........#.........#....................
.........#.........#....................
####.....#.........#....................
.........#.........#....................
...T....##.........#....................
x..................#....................
##...T.......@.....#....................
##.................#....................
#####..............#....................
########################################
.........#.........#.........#.........#
####.....#.........#.........#.........#
.........#.........#.........#.........#
...T....##.........#.........#.........#
x..................#.........#.........#
##...T.............#.........#.........#
##.................#.........#.........#
#####..............#.........#.........#
........................................
x........#.........#....................
.........#.........#....................
####.....#.........#....................
.........#.........#....................
...T....##.........#....................
x..................#....................
##...T.............#....................
##.................#....................
#####..............#....................
#####..............#....................