##########
........T.
@.........
####......
..........
...T...###
..........
##........
.........x
#####.....