##########
@........#
.........#
####.....#
.........#
...T....##
x.........
##...T....
##........
#####.....